+---+---+---+---+---+---+---+---+---+---+
|   |           |                       |
+   +---+   +   +   +   +---+---+---+   +
|       |   |       |           |       |
+---+   +   +---+---+---+---+   +---+---+
|   |   |   |               |           |
+   +   +   +   +---+---+   +---+---+   +
|       |   |           |       |       |
+   +---+   +---+---+   +---+   +   +---+
|   |                   |       |       |
+   +---+---+---+---+---+   +---+---+   +
|                   |       |           |
+---+---+---+---+   +---+---+   +---+   +
|               |               |       |
+   +---+---+   +---+---+---+---+   +---+
|           |   |               |       |
+   +---+   +---+   +   +   +---+---+   +
|   |   |           |   |   |       |   |
+   +   +---+---+---+   +---+   +   +   +
|                   |           |       |
+---+---+---+---+---+---+---+---+---+---+
