+---+---+---+---+---+---+---+---+---+---+
|       |           |                   |
+---+   +   +---+   +   +---+   +---+---+
|       |       |   |       |           |
+   +---+---+   +   +---+   +---+---+   +
|       |       |               |   |   |
+---+   +   +---+---+---+---+   +   +   +
|       |           |       |       |   |
+   +---+---+---+---+   +   +---+---+   +
|                       |           |   |
+---+---+---+---+---+---+---+---+   +   +
|   |                           |   |   |
+   +   +---+   +---+---+   +---+   +   +
|   |   |   |       |       |       |   |
+   +   +   +---+   +---+---+   +---+   +
|   |           |           |       |   |
+   +---+---+   +---+---+   +---+   +   +
|           |           |           |   |
+   +---+---+---+---+   +---+---+---+   +
|                                       |
+---+---+---+---+---+---+---+---+---+---+
